moral	[ˈmɒrəl] adj. 道德的；道义上的 n. 品行；道德；寓意
virtue	[ˈvɜ:tʃu:] n. 高尚的道德；美德；优秀品质
dilemma	[dɪˈlemə] n. 进退两难的境地；困境
faint	[feɪnt] vi. 昏倒；晕厥 adj. 不清楚的；微弱的
illustrate	[ˈɪləstreɪt] vt. （举例）说明；阐明；给（书或文章）加插图
precious	[ˈpreʃəs] adj. 珍稀的；宝贵的
entrust	[ɪnˈtrʌst] vt. 委托；交付
carry sb through	[θru:] sth  帮助某人渡过难关
marriage	[ˈmærɪdʒ] n. 结婚；婚姻
majority	[məˈdʒɒrəti] n. 大部分；大多数
complain	[kəmˈpleɪn] vi. & vt. 抱怨；发牢骚
tuition	[tjuˈɪʃn] n. （小组）教学；讲课
fee	[fi:] n. 专业服务费；报酬
respond	[rɪˈspɒnd] vt. 回答；回复 vi. 做出反应；回应
response	[rɪˈspɒns] n. 反应；回答；回复
union	[ˈju:niən] n. 协会；联合会；工会
scholarship	[ˈskɒləʃɪp] n. 奖学金
hire	[ˈhaɪə(r)] vt. 聘任；雇用；租用 n. 租借；租用
physician	[fɪˈzɪʃn] n. 医师；（尤指）内科医生
resident	[ˈrezɪdənt] physician  住院医师
colleague	[ˈkɒli:g] n. 同事；同僚
reject	[rɪˈdʒekt] vt. 拒绝接受；不录用
rejection	[rɪ'dʒekʃn] n. 拒绝接受；否决
appoint	[əˈpɔɪnt] vt. 任命；委派
faraway	[ˈfɑ:rəweɪ] adj. 遥远的
elect	[ɪˈlekt] vt. 选举；推选
election	[ɪˈlekʃn] n. 选举；推选；当选
decade	[ˈdekeɪd] n. 十年；十年期
elsewhere	[ˌelsˈweə(r)] adv. 在别处；去别处
tend	[tend] vt. 照顾；照料 vi. 倾向；趋于
publish	[ˈpʌblɪʃ] vt. 发表（作品）；出版
staff	[stɑ:f] n. 员工；全体职员
retire	[rɪˈtaɪə(r)] vi. & vt. 退休；退职；退出
saving	[ˈseɪvɪŋ] n. 节省物；节省；节约；[pl.] 储蓄金；存款
kindergarten	[ˈkɪndəgɑ:tn] n. 学前班；幼儿园
principle	[ˈprɪnsəpl] n. 道德原则；法则；原则
passive	[ˈpæsɪv] adj. 被动的；顺从的
scared	[skeəd] adj. 害怕的；对……感到惊慌或恐惧的
scare	[skeə(r)] vt. 惊吓；使害怕 vi. 受惊吓
sharp	[ʃɑ:p] adj. （增长、下跌等）急剧的；锋利的；明显的
insurance	[ɪnˈʃʊərəns] n. 保险；保险业
energetic	[ˌenəˈdʒetɪk] adj. 精力充沛的；充满活力的
replace	[rɪˈpleɪs] vt. 接替；取代；更换
accident	[ˈæksɪdənt] n. 事故；车祸；失事
operation	[ˌɒpəˈreɪʃn] n. 手术；企业；经营
whisper	[ˈwɪspə(r)] vi. & vt. 悄声说；耳语；低语 n. 耳语（声）；低语（声）；传言；谣传
midnight	[ˈmɪdnaɪt] n. 子夜；午夜
import	[ˈɪmpɔ:t] n. 进口；进口商品 vt. 进口；输入；引进
export	[ˈekspɔ:t] n. 出口；出口商品 vt. 出口；输出；传播
pole	[pəʊl] n. （行星的）极；地极
lap	[læp] n. （坐着时的）大腿部；（跑道等的）一圈
bite	[baɪt] vt. & vi. (bit, bitten) 咬；叮；蛰 n. 咬；（咬下的）一口；咬伤
lip	[lɪp] n. 嘴唇
assist	[əˈsɪst] vt. 帮助；援助
first aid	[eɪd] 急救
chairman	[ˈtʃeəmən] n. 主席；主持人；董事长
memory	[ˈmeməri] n. 记忆力；回忆
chain	[tʃeɪn] n. 一连串（人或事）；链子；链条
waitress	[ˈweɪtrəs] n. （餐馆的）女服务员；女侍者
pregnant	[ˈpregnənt] adj. 怀孕的；妊娠的
disguise	[dɪsˈgaɪz] vt. 装扮；假扮；掩盖 n. 伪装；化装用具
maple	[ˈmeɪpl] n. 枫树；槭树
cart	[kɑ:t] n. 手推车；运货马车
spill	[spɪl] vt. & vi. (spilt/spilled, spilt/spilled) （使）洒出；（使）溢出
trip	[trɪp] over  被……绊倒
limp	[lɪmp] vi. 跛行；一瘸一拐地走
tear	[teə(r)] n. 眼泪；泪水
harm	[hɑ:m] n. & vt. 伤害；损害
despair	[dɪˈspeə(r)] n. 绝望 vi. 绝望，感到无望
might	[maɪt] n. 力量；威力
fable	[ˈfeɪbl] n. 寓言；寓言故事
court	[kɔ:t] n. （网球等的）球场；法院；法庭
flexible	[ˈfleksəbl] adj. 灵活的；可变通的
income	[ˈɪnkʌm] n. 收入；收益
per	[pə(r)] prep. 每；每一
therefore	[ˈðeəfɔ:(r)] adv. 因此；所以
tension	[ˈtenʃn] n. 紧张关系；紧张；焦虑
moral dilemma	道德困境
tuition fees	学费
tend to do sth	易于做某事；往往会发生某事
pass away	去世
in memory of	作为对……的纪念
in tears	流着泪；含着泪
in despair	处于绝望中
a great deal	(of)  大量
