bounce	[baʊns] vi. & vt. （使）弹起；上下晃动 n. 弹性；弹跳；活力
aptitude	[ˈæptɪtju:d] n. 天资；天赋
scenario	[səˈnɑ:riəʊ] n. 设想；方案；预测
lawyer	[ˈlɔ:jə(r)] n. 律师
assemble	[əˈsembl] vt. 组装；装配 vi. & vt. 收集；聚集；集合
drawer	[drɔ:(r)] n. 抽屉
a chest	[tʃest] of drawers  抽屉柜
breast	[brest] n. 乳房；胸部
hydrogen	[ˈhaɪdrədʒən] n. 氢；氢气
radium	[ˈreɪdiəm] n. 镭
wrist	[rɪst] n. 手腕；腕关节
bridegroom	[ˈbraɪdgru:m] n. 新郎
geometry	[dʒiˈɒmətri] n. 几何学；几何图形
debt	[det] n. 债务；欠款
categorise	['kætəgəraɪz] vt. 把……分类（加以归类）
profile	[ˈprəʊfaɪl] n. 简介；概述；侧面轮廓 vt. 扼要介绍；概述；写简介
participant	[pɑ:ˈtɪsɪpənt] n. 参与者；参加者
code	[kəʊd] n. 代码；密码 vt. 编码；把……译成密码
orient	[ˈɔ:rient] vt. 使适应；使面对；确定方向
detective	[dɪˈtektɪv] n. 侦探；警探
graphic	[ˈgræfɪk] n. 图表；图形；图画 adj. 绘画的；图案的
estate	[ɪˈsteɪt] n. 庄园；住宅区；工业区
estate agent	[ˈeɪdʒənt] 房地产经纪人
accountant	[əˈkaʊntənt] n. 会计；会计师
spy	[spaɪ] n. 密探；间谍 vi. 从事间谍活动 vt. 突然看见；发现
justice	[ˈdʒʌstɪs] n. 公平；公正；合理
accuse	[əˈkju:z] vt. 控告；控诉；谴责
come to a conclusion	[kənˈklu:ʒn] 得出结论
greedy	[ˈgri:di] adj. 贪婪的；贪心的
entrepreneur	[ˌɒntrəprəˈnɜ:(r)] n. 创业者；企业家
receptionist	[rɪˈsepʃənɪst] n. 接待员
socialist	[ˈsəʊʃəlɪst] adj. 社会主义的 n. 社会主义者
communist	[ˈkɒmjənɪst] adj. 共产主义的 n. 共产主义者
fox	[fɒks] n. 狐狸；狡猾的人
council	[ˈkaʊnsl] n. 委员会；市政服务机构
canal	[kəˈnæl] n. 运河；灌溉渠
attend	[əˈtend] to  关怀；照料；处理
supervise	[ˈsu:pəvaɪz] vt. & vi. 主管；指导；监督
handwriting	[ˈhændraɪtɪŋ] n. 书法；书写；笔迹
disk	[dɪsk] (disc)  n. 磁盘；盘
parking	[ˈpɑ:kɪŋ] n. 停车位；停车
camel	[ˈkæml] n. 骆驼
fry	[fraɪ] n. 油煎的食物 vt. & vi. 油炸；油炒；油煎
purse	[pɜ:s] n. 钱包；皮夹子（尤指女用）
sew	[səʊ] vi. & vt. (sewed, sewn/sewed) 缝制；缝；做针线活
knit	[nɪt] vt. & vi. 编织；针织；（使）紧密结合 n. 编织的衣服；针织衫
wool	[wʊl] n. 毛；毛线；毛料
priority	[praɪˈɒrəti] n. 优先事项；首要的事；优先
proficiency	[prə'fɪʃnsɪ] n. 熟练；娴熟；精通
cage	[keɪdʒ] n. 笼子 vt. 关在笼子里
collar	[ˈkɒlə(r)] n. （动物）颈圈；衣领
flea	[fli:] collar  灭蚤颈圈
finance	[ˈfaɪnæns] n. 资金；财政；金融 vt. 提供资金
receipt	[rɪˈsi:t] n. 收据；接收
certificate	[səˈtɪfɪkət] n. 合格证书；证明
employer	[ɪmˈplɔɪə(r)] n. 雇主；老板
desert	[ˈdezət] n. 沙漠；荒漠
acquire	[əˈkwaɪə(r)] vt. 获得；购得
bounce around	蹦来蹦去；弹来弹去
head start	起步前的优势
a	chest [tʃest]  of drawers  抽屉柜
cv	(NAmE résumé)  n. 履历；简历
dedicate	英 [ˈdedɪkeɪt] vt. 把……奉献给
to	关怀；照料；处理
intermediate	[ˌɪntəˈmi:diət]adj. 中级的；中等的；中间的
