exchange	[ɪksˈtʃendʒ] n. 交换；交流 vt. 交换；交流；交易；兑换
lecture	[ˈlɛktʃɚ] n. 讲座；讲课；教训 vi.（开）讲座；讲课 vt. 训斥
registration	[ˌrɛdʒɪˈstreʃən] n. 登记；注册；挂号
register	[ˈrɛdʒɪstɚ] vt. & vi. 登记；注册
sex	[sɛks] n. 性别
female	[ ˈfiˌmel] adj. 女（性）的；雌的 n. 雌性动（植）物；女子
male	[ˈmel] adj. 男（性）的；雄的 n. 雄性动（植）物；男子
nationality	[ˌnæʃəˈnæləti] n. 国籍；民族
nation	[ˈneʃən] n. 国家；民族；国民
designer	[dɪˈzaɪnə] n. 设计者
design	[dɪˈzaɪn] n. 设计；设计方案 vt. 设计；筹划
campus	[ˈkæmpəs] n. 校园；校区
formal	[ˈfɔrml] adj. 正式的；正规的
anxious	[ˈæŋkʃəs] adj. 焦虑的；不安的
annoyed	[əˈnɔɪd] adj. 恼怒的；生气的
annoy	[əˈnɔɪ] vt. 使恼怒；打扰
frightened	[ˈfraɪtnd] adj. 惊吓的；害怕的
senior	[ˈsinjɚ] adj. 级别（或地位）高的 n. 较年长的人
outgoing	[ˈaʊtgoʊɪŋ] adj. 爱交际的；外向的
impression	[ɪmˈprɛʃən] n. 印象；感想
impress	[ɪmˈprɛs] vt. 使钦佩；给……留下深刻的好印象 vi. 留下印象；引人注目
guy	[ɡaɪ] n. 小伙子；男子；家伙
concentrate	[ˈkɑnsntreɪt] vi. & vt. 集中（注意力）；聚精会神
experiment	[ɪkˈspɛrəmənt] n. 实验；试验
alone	[əˈloʊn] 不打扰；不惊动
awkward	[ˈɔkwərd] adj. 令人尴尬的；难对付的
junior	[ˈdʒunjɚ] adj. 地位（或职位、级别）低下的 n. 职位较低者；（体育运动中）青少年
explore	[ɪkˈsplɔr] vt. & vi. 探索；勘探
confident	[ˈkɑnfɪdənt] adj. 自信的；有把握的
confidence	[ˈkɑnfɪdəns] n. 信心；信任
forward	[ˈfɔrwərd] adv. (also forwards) 向前；前进 adj. 向前的；前进的
take notes	[nəuts] 记笔记
flash	[flæʃ] n. 光；信号 vi. 闪耀；闪光；发出信号 vt. 使闪耀；发出（信号）
flash card	[kɑrd] 教学卡片；识字卡
organise	['ɔgənaɪz] (NAmE -ize) vt. 组织；筹备；安排；组建 vi. 组建；成立
organisation	[ˌɔgənaɪ'zeɪʃən] (NAmE -ization) n. 组织；团体；机构
goal	[goʊl] n. 目标；球门；射门
strategy	[ˈstrætədʒi] n. 策略；策划
partner	[ˈpɑrtnə(r)] n. 同伴；配偶；合伙人
improve	[ɪmˈpruv] vi. & vt. 改进；改善
curious	[ˈkjʊriəs] adj. 好奇的；求知欲强的
company	[ˈkʌmpəni] n. 公司；商行；陪伴
personality	[ˌpɜrsəˈnæləti] n. 性格；个性
style	[staɪl] n. 方式；作风
revise	[rɪˈvaɪz] vt. & vi. 修改；修订；复习
senior high school	（美国）高中
at last	终于；最终
make an impression	留下好印象
what if	要是……会怎么样呢？
concentrate on	集中精力于
leave	... alone  [əˈloʊn]   不打扰；不惊动
junior high school	（美国）初级中学
look forward to	盼望；期待
take	notes [nəuts] 记笔记
