buffet	[bəˈfeɪ] vt. 连续猛击；打来打去 n. 自助餐
cloth	[klɔθ] n. （一块）布；织物；布料
edge	[ɛdʒ] n. 边；边缘；边线；刀刃 vt. & vi. （使）徐徐移动；给……加边
valley	[ˈvæli] n. 谷；山谷；溪谷
vast	[væst] adj. 辽阔的；巨大的；庞大的
glacier	[ˈgleɪʃər] n. 冰川
reindeer	[ˈreɪndɪr] n. 驯鹿
territory	[ˈterətɔri] n. 领土；版图；领域；地盘
ban	[bæn] vt. 明令禁止；取缔  n. 禁令
boundary	[ˈbaʊndəri, -dri] n. 边界；界限；分界线
cottage	[ˈkɑtɪdʒ] n. 小屋；（尤指）村舍；小别墅
visible	[ˈvɪzəbəl] adj. 看得见的；可见的
accompany	[əˈkʌmpəni, əˈkʌmpni] vt. 陪同；陪伴；伴随；（尤指用钢琴）为……伴奏
adopt	[əˈdɒpt] vt. 采用；采取；采纳 vt. & vi. 领养
sour	[saʊr] adj. 酸的；有酸味的
bless	[blɛs] vt. 祝福
prohibition	[ˌproʊəˈbɪʃn] n. 禁止；阻止；禁令
prohibit	[proˈhɪbɪt] vt. （尤指以法令）禁止；阻止
journalist	[ˈdʒɜrnəlɪst] n. 新闻记者；新闻工作者
sneeze	[sniz] vi. 打喷嚏 n. 喷嚏；喷嚏声
teapot	[ˈtipɑt] n. 茶壶
label	[ˈleɪbl] vt. 用标签标明；贴标签 n. 标签；标记
cream	[krim] n. 奶油；乳脂；护肤霜 adj. 奶油色的；濙黄色的
leopard	[ˈlepərd] n. 豹
stretch	[strɛtʃ] vi. 延伸；延续 vi. & vt. 伸展；舒展
rewarding	[rɪˈwɔrdɪŋ] adj. 值得做的；有益的
bush	[bʊʃ] n. 灌木
lung	[lʌŋ] n. 肺
cycle	[ˈsaɪkəl] n. 自行车；摩托车；循环 vi. 骑自行车
corridor	[ˈkɔrɪdɚ, -ˌdɔr, ˈkɑr-] n. 狭长地带；走廊；过道；通道
pedal	[ˈpedl] n. （自行车等的）脚蹬子；踏板 vt. & vi. 骑自行车；踩踏板
fountain	[ˈfaʊntn] n. 喷泉；人工喷泉；喷水池
route	[rut, raʊt] n. 路线；路途；途径
ahead	[əˈhed] adv. 向前；在前面；提前
theme	[θim] adj. 有特定主题的 n. 主题；主题思想
roller	[ˈroʊlə(r)] coaster  [ˈkoʊstə(r)]   n. 过山车
incredible	[ɪnˈkrɛdəbəl] adj. 极好的；极大的；难以置信的
appeal	[əˈpil] vi. 有吸引力；呼吁；恳求；上诉 n. 吸引力；呼吁；上诉；请求
pirate	[ˈpaɪrɪt] n. 海盗；盗版者 vt. 盗印；窃用
adorable	[əˈdɔrəbəl,əˈdor-] adj. 可爱的；讨人喜爱的
wander	[ˈwɒndə(r)] n. 游荡；闲逛；流浪 vt. & vi. 闲逛；漫游 vi. 走失；离散；走神
amusement	[əˈmjuzmənt] n. 娱乐（活动）；愉悦
amuse	[əˈmjuz] vt. （提供）消遣；（使）娱乐
enormous	[ɪˈnɔrməs] adj. 巨大的；极大的
swing	[swɪŋ] vt. & vi. (swung, swung) （使）摆动；摇摆；转弯；（使）突然转向
iron	[ˈaɪən] n. 铁；铁器；铸铁；熨斗 vt. & vi. （用熨斗）熨；烫平
fashion	[ˈfæʃən] n. 时尚；时兴；流行款式
rare	[rer] adj. 稀少的；珍贵的；（肉）半熟的
steam	[stim] n. 蒸汽；水蒸气；蒸汽动力 vi. 蒸发；散发蒸汽；冒水汽
superb	[su:ˈpɜ:b] adj. 极佳的；卓越的
aquarium	[əˈkweriəm] (pl. aquariums or aquaria) n. 水族馆；水族玻璃槽；养鱼缸
polar	[ˈpoʊlə(r)] adj. （近）极地的；南极（或北极）的；磁极的
splendid	[ˈsplendɪd] adj. 壮丽的；雄伟的；极佳的；非常好的
display	[dɪˈsple] n. 展览；陈列；展览品vt. 显示；陈列
appetite	[ˈæpɪtaɪt] n. 食欲；胃口；强烈欲望
entertainment	[ˌentəˈteɪnmənt] n. 娱乐；招待；娱乐活动；文娱节目
column	[ˈkɒləm] n. （书、报纸印刷页上的）栏；专栏；柱（形物）
on the move	在行进中；在移动中
set out	出发；启程；（怀着目标）开始工作
live off	依靠……生活；以吃……为生
theme park	主题公园；主题乐园
coaster	[ˈkoʊstə(r)]   n. 过山车
appeal to	有吸引力；有感染力；呼吁；上诉；打动
up to	达到（某数量、程度等）；直到；不多于；（体力或智力上）能胜任
upside down	颠倒；倒转；翻转
