parcel	[ˈpɑ:sl] n. 包裹 vt. 裹好；打包
jam	[dʒæm] n. 果酱；堵塞
mail	[meɪl] n. 邮件；信件；邮政 vt. 邮寄；发电邮给
secondary	[ˈsekəndri] adj. 中学的；次要的
clay	[kleɪ] n. 黏土；陶土
dust	[dʌst] n. 沙土；灰尘 vi. & vt. 擦灰
dusty	[ˈdʌsti] adj. 布满灰尘的
weed	[wi:d] n. 杂草；野草 vt. & vi. 除杂草
cotton	[ˈkɒtn] n. 棉布；棉花
uniform	[ˈju:nɪfɔ:m] n. 校服；制服 adj. 一致的；统一的
tablet	[ˈtæblət] n. 平板电脑；便笺本；药片
rubber	[ˈrʌbə(r)] n. 橡皮；黑板擦；橡胶
washroom	[ˈwɒʃru:m] n. 洗手间；厕所
rigid	[ˈrɪdʒɪd] adj. 死板的；固执的
bubble	[ˈbʌbl] vi. 起泡；沸腾
tube	[tju:b] n. 管子；管状物
circus	[ˈsɜ:kəs] n. 马戏团
chemist	[ˈkemɪst] n. 化学家；药剂师；药房
shade	[ʃeɪd] vt. 给……遮挡（光线）；加灯罩；把……涂暗 n. 阴凉处；灯罩；阴影部分
jaw	[dʒɔ:] n. 颌；下巴
wrinkle	[ˈrɪŋkl] vt. & vi. （使脸上）起皱纹；皱起 n. 皱纹
forehead	[ˈfɔ:hed] n. 额；前额
hut	[hʌt] n. 简陋的小房子（或棚、舍）
housing	[ˈhaʊzɪŋ] n. 住房；住宅
platform	[ˈplætfɔ:m] n. 平台；站台；舞台
fireplace	[ˈfaɪəpleɪs] n. 壁炉
saucer	[ˈsɔ:sə(r)] n. 茶碟；杯托
kettle	[ˈketl] n. （烧水用的）壶；水壶
pan	[pæn] n. 平底锅；烤盘
jar	[dʒɑ:(r)] n. 罐子；坛子
ripe	[raɪp] adj. 成熟的；时机成熟的
grill	[grɪl] n. 烤架；烤肉餐馆
doorway	[ˈdɔ:weɪ] n. 门口；出入口；门道
leftover	[ˈleftəʊvə(r)] adj. 吃剩的；残留的 n. 吃剩的食物；遗留物
handshake	[ˈhændʃeɪk] n. 握手
drag	[dræg] vt. 拖；拽 vt. & vi. 缓慢而费力地移动
privilege	[ˈprɪvəlɪdʒ] n. 优惠待遇；特权
plug	[plʌg] vt. 封堵；补足 n. 堵塞物；插头；插座
disabled	[dɪsˈeɪbld] adj. 有残疾的；丧失能力的
resign	[rɪˈzaɪn] vi. & vt. 辞职；辞去
deserve	[dɪˈzɜ:v] vt. 值得；应得；应受
lately	[ˈleɪtli] adv. 最近；不久前；近来
input	[ˈɪnpʊt] n. 情况；信息；投入；输入 vt. 输入
tune	[tju:n] n. 曲调；曲子 vt. 调音；调节；调频道
contract	[ ˈkɒntrækt] vt. 感染（疾病）；与……订立合同（或契约） n. 合同；契约
grant	[grɑ:nt] vt. 同意；准许 n. 拨款
cardiac	[ˈkɑ:diæk] adj. 心脏病的；心脏的
circuit	[ˈsɜ:kɪt] n. 巡回；环形线路
disability	[ˌdɪsəˈbɪləti] n. 缺陷；障碍
consultation	[ˌkɒnslˈteɪʃn] n. 咨询；咨询会
relay	[ˈri:leɪ] vt. 转发；转播 n. 接力赛；接班的人
criterion	[kraɪˈtɪəriən] n. (pl. criteria) 标准；准则；原则
stability	[stəˈbɪləti] n. 稳定（性）；稳固（性）
pray	[preɪ] vi. & vt. 企盼；祈祷
hypothetical	[ˌhaɪpəˈθetɪkl] adj. 假设的；假定的
a chorus of	齐声；异口同声
not to mention	更不用说；且不说
take for granted	认为……是理所当然；对……不予重视
relay to	转达给……；转发给……
pray that	但愿
