blog	[blɒg] n. 博客 vi. 写博客
blog post	[pəʊst] 博文；博客帖子
blogger	['blɒɡə(r)] n. 博客作者；博主
engine	[ˈendʒɪn] n. 引擎；发动机；火车头
search	[sɜ:tʃ] engine  （互联网上的）搜索引擎
chat	[tʃæt] vi. 聊天；闲聊
stream	[stri:m] vt. 流播（不用下载直接在互联网上播放音视频）；流出 vi. 流动 n. 小河；溪流
identity	[aɪˈdentəti] n. 身份；个性
convenient	[kənˈvi:niənt] adj. 方便的；近便的
cash	[kæʃ] n. 现金；金钱
update	[ˌʌpˈdeɪt] vt. 更新；向……提供最新信息 n. 更新；最新消息
database	[ˈdeɪtəbeɪs] n. 数据库；资料库
software	[ˈsɒftweə(r)] n. 软件
network	[ˈnetwɜ:k] n. （互联）网络；网状系统；人际网 vt. 将……连接成网络；联播 vi. 建立工作关系
stuck	[stʌk] adj. 卡住；陷（入）；困（于）
keep sb company	[ˈkʌmpəni] 陪伴某人
surf	[sɜ:f] vt. & vi. 浏览；冲浪
benefit	[ˈbenɪfɪt] n. 益处 vt. 使受益 vi. 得益于
distance	[ˈdɪstəns] n. 距离
inspire	[ɪnˈspaɪə(r)] vt. 鼓舞；激励；启发思考
access	[ˈækses] n. 通道；（使用、查阅、接近或面见的）机会 vt. 进入；使用；获取
charity	[ˈtʃærəti] n. 慈善；慈善机构（或组织）
go through	[θru:] 经历；度过；通读
tough	[tʌf] adj. 艰难的；严厉的
province	[ˈprɒvɪns] n. 省
conference	[ˈkɒnfərəns] n. 会议；研讨会；正式会谈
resident	[ˈrezɪdənt] n. 居民；（美国的）住院医生 adj.（在某地）居住的
plus	[plʌs] conj. 而且；此外 n. 加号；优势 prep. 加；另加
function	[ˈfʌŋkʃn] n. 功能；作用；机能 vi. 起作用；正常工作；运转
battery	[ˈbætri] n. 电池
confirm	[kənˈfɜ:m] vt. 确认；使确信
wi-fi	[ˈwaɪ faɪ] n. 无线保真（用无线电波而非网线在计算机网络传输数据的系统）
press	[pres] vt. 按，压；敦促
button	[ˈbʌtn] n. 按钮；纽扣
file	[faɪl] n. 文件；文件夹；档案
in shape	[ʃeɪp] 状况良好
keep track	[træk] of  掌握……的最新消息；了解……的动态
discount	[ˈdɪskaʊnt] n. 折扣 vt. 打折
account	[əˈkaʊnt] n. 账户；描述
click	[klɪk] vt. & vi. 点击
privacy	[ˈprɪvəsi] n. 隐私；私密
theft	[θeft] n. 偷（窃）；盗窃罪
rude	[ru:d] adj. 粗鲁的；无礼的
target	[ˈtɑ:gɪt] n. 目标；对象；靶子 vt. 把……作为攻击目标
troll	[trɒl] n. 发挑衅帖子的人；恶意挑衅的帖子
cyberbully	[ˈsaɪbərbʊli] n. 网霸 vt. & vi. 网络欺凌
false	[fɔ:ls] adj. 假的；错误的
particular	[pəˈtɪkjələ(r)] adj. 特定的；特别的；讲究的
embarrassing	[ɪmˈbærəsɪŋ] adj. 让人难堪（尴尬；害羞）的
upset	[ʌpˈset] adj. 心烦的；苦恼的；沮丧的 vt. (upset, upset) 使烦恼；使生气；搅乱
guideline	[ˈgaɪdlaɪn] n. 准则；指导原则
author	[ˈɔ:θə(r)] n. 作者；作家
tip	[tɪp] n. 忠告；诀窍；实用的提示
familiar	[fəˈmɪliə(r)] adj. 熟悉；熟知
in mind	[maɪnd] 牢记
define	[dɪˈfaɪn] vt. 给……下定义；界定；解释
case	[keɪs] n. 盒；箱；情况；案件
identity card	身份证
keep sb	company [ˈkʌmpəni]  陪伴某人
now that	既然；由于
make fun of	取笑；戏弄
keep	(...) in mind  [maɪnd] 牢记
